0,0,0,0,7,7,5,5,5,7,8,0,0,0,0,0,0,0,0,0,0,0,0,0,0,0,0,0,0,0,0,0,0,0,0,0,0,0,0,0,
0,0,0,7,7,5,5,5,7,8,8,7,7,7,7,7,7,7,7,7,0,0,0,0,0,0,0,0,0,0,0,0,0,0,0,0,0,0,0,0,
0,0,7,7,5,5,5,7,7,8,7,7,5,5,5,5,5,5,5,7,7,8,8,8,0,0,0,0,0,0,0,0,0,0,0,0,0,0,0,0,
0,0,7,5,5,5,7,7,8,7,7,5,5,5,5,5,5,5,5,5,5,5,5,8,8,8,8,8,8,8,8,8,8,8,0,0,0,0,0,0,
0,0,7,5,5,5,7,7,7,7,5,5,5,5,5,5,5,5,5,5,5,5,5,5,5,5,5,5,5,5,5,5,5,8,8,0,0,0,0,0,
0,0,7,5,5,5,7,7,5,5,5,5,5,5,7,7,5,5,5,5,5,5,5,5,5,5,5,5,5,5,5,5,5,5,8,8,0,0,0,0,
0,0,7,5,5,5,7,7,5,5,5,5,7,7,7,7,7,7,7,7,7,7,7,5,5,5,5,5,5,5,5,5,5,5,5,8,0,0,0,0,
0,0,7,5,5,5,5,5,5,5,7,7,7,0,0,0,0,0,0,0,0,0,7,7,7,7,7,7,5,5,5,5,5,5,5,8,8,0,0,0,
0,0,7,7,5,5,5,5,5,7,7,0,0,0,0,0,0,0,0,0,0,0,0,0,0,0,0,7,7,7,5,5,5,5,5,5,8,0,0,0,
0,0,0,7,7,5,5,5,7,7,0,0,0,0,0,0,0,0,0,0,0,0,0,0,0,0,0,0,0,7,7,5,5,5,5,5,8,0,0,0,
0,0,0,0,7,7,7,7,7,0,0,0,0,0,0,0,0,0,0,0,0,0,0,0,0,0,0,0,0,0,7,5,5,5,5,5,8,0,0,0,
0,0,0,0,0,0,0,0,0,0,0,0,0,0,0,0,0,0,0,0,0,0,0,0,0,0,0,0,0,0,7,5,5,5,5,5,8,0,0,0,
9,9,9,9,9,9,8,6,7,8,7,6,6,7,7,7,7,8,8,8,8,9,8,9,8,9,9,8,7,7,7,7,5,5,5,7,8,8,8,9,
1,1,1,1,1,1,1,1,1,1,1,1,1,1,1,1,1,1,1,1,1,1,1,1,1,1,1,1,1,1,1,1,5,5,5,1,1,1,1,1,
1,1,1,1,1,1,1,1,1,1,1,1,1,1,1,1,1,1,1,1,1,1,1,1,1,1,1,1,1,1,1,1,5,5,5,1,1,1,1,1,
1,1,1,1,1,1,1,1,1,1,1,1,1,1,1,1,1,1,1,1,1,1,1,1,1,1,1,1,1,1,1,1,5,5,5,1,1,1,1,1,
1,1,1,1,1,1,1,1,1,1,1,1,1,1,1,1,1,1,1,1,1,1,1,1,1,1,1,1,1,1,1,1,5,5,5,1,1,1,1,1,
1,1,1,1,1,1,1,1,1,1,1,1,1,1,1,1,1,1,1,1,1,1,1,1,1,1,1,1,1,1,1,1,5,5,5,1,1,1,1,1,
1,1,1,1,1,1,1,1,1,1,1,1,1,1,1,1,1,1,1,1,1,1,1,1,1,1,1,1,1,1,1,1,5,5,5,1,1,1,1,1,
1,1,1,1,1,1,1,1,1,1,1,1,1,1,1,1,1,1,1,1,1,1,1,1,1,1,1,1,1,1,1,1,5,5,5,1,1,1,1,1,
1,1,1,1,1,1,1,1,1,1,1,1,1,1,1,1,1,1,1,1,1,1,1,1,1,1,1,1,1,1,1,1,5,5,5,1,1,1,1,1,
1,1,1,1,1,1,1,1,1,1,1,1,1,1,1,1,1,1,1,1,1,1,1,1,1,1,1,1,1,1,1,1,5,5,5,1,1,1,1,1,
1,1,1,1,1,1,1,1,1,1,1,1,1,1,1,1,1,1,1,1,1,1,1,1,1,1,1,1,1,1,1,1,5,5,5,1,1,1,1,1,
1,1,1,1,1,1,1,1,1,1,1,1,1,1,1,1,1,1,1,1,1,1,1,1,1,1,1,1,1,1,1,1,5,5,5,1,1,1,1,1,
7,7,7,8,8,8,8,9,9,8,8,8,7,7,8,8,9,9,9,9,9,8,8,8,8,8,8,7,7,7,7,7,5,5,5,8,8,8,9,9,
0,0,0,0,0,0,0,0,0,0,0,0,0,0,0,0,0,0,0,0,0,0,0,0,0,0,0,0,0,0,8,5,5,5,5,5,8,0,0,0,
0,0,0,0,0,0,0,0,0,0,0,0,0,0,0,0,0,0,0,0,0,0,0,0,0,0,0,0,0,0,8,5,5,5,5,5,8,0,0,0,
0,0,0,0,0,0,0,0,0,0,0,0,0,0,0,0,0,0,0,0,0,0,0,0,0,0,0,0,0,0,8,5,5,5,5,5,8,0,0,0,
0,0,0,0,0,0,0,0,0,0,0,0,0,0,0,0,0,0,0,0,0,0,0,0,0,0,0,0,0,0,8,5,5,5,5,5,8,0,0,0,
0,0,0,0,0,0,0,0,0,0,0,0,0,0,0,0,0,0,0,0,0,0,0,0,0,0,0,0,0,0,8,5,5,5,5,5,8,0,0,0,
0,0,0,0,0,0,0,0,0,0,0,0,0,0,0,0,0,0,0,0,0,0,0,0,0,0,0,0,0,0,9,5,5,5,5,5,8,0,0,0,
0,0,0,0,0,0,0,0,0,0,0,0,0,0,0,0,0,0,0,0,0,0,0,0,0,0,0,0,0,9,9,5,5,5,5,8,8,0,0,0,
0,0,0,0,0,0,0,0,0,0,7,7,7,7,7,7,7,7,8,8,0,0,0,0,0,0,0,0,9,9,5,5,5,5,5,8,0,0,0,0,
0,0,0,0,0,0,0,0,0,7,7,5,5,5,5,5,5,5,5,8,8,8,0,0,0,0,0,0,9,5,5,5,5,5,8,8,0,0,0,0,
0,0,0,0,0,0,0,0,7,7,5,5,5,5,5,5,5,5,5,5,5,8,9,9,9,0,9,9,9,5,5,5,5,5,8,0,0,0,0,0,
0,0,0,0,0,0,0,0,7,5,5,5,5,5,5,5,5,5,5,5,5,5,5,5,9,9,9,5,5,5,5,5,5,8,8,0,0,0,0,0,
0,0,0,0,0,0,0,7,7,5,5,5,7,8,8,8,8,5,5,5,5,5,5,5,5,5,5,5,5,5,5,5,9,8,0,0,0,0,0,0,
0,0,0,0,0,0,0,7,5,5,5,7,7,0,0,0,9,9,9,9,5,5,5,5,5,5,5,5,5,5,5,9,9,0,0,0,0,0,0,0,
0,0,0,0,0,0,0,7,5,5,5,7,0,0,0,0,0,0,0,9,9,9,5,5,5,5,5,5,5,9,9,9,0,0,0,0,0,0,0,0,
0,0,0,0,0,0,0,7,5,5,5,7,0,0,0,0,0,0,0,0,0,9,9,9,9,9,9,9,9,9,0,0,0,0,0,0,0,0,0,0