0000775557800000000000000000000000000000
0007755578877777777700000000000000000000
0077555778775555555778880000000000000000
0075557787755555555555588888888888000000
0075557777555555555555555555555558800000
0075557755555577555555555555555555880000
0075557755557777777777755555555555580000
0075555555777000000000777777555555588000
0077555557700000000000000007775555558000
0007755577000000000000000000077555558000
0000777770000000000000000000007555558000
0000000000000000000000000000007555558000
9999998678766777788889898998777755578889
1111111111111111111111111111111155511111
1111111111111111111111111111111155511111
1111111111111111111111111111111155511111
1111111111111111111111111111111155511111
1111111111111111111111111111111155511111
1111111111111111111111111111111155511111
1111111111111111111111111111111155511111
1111111111111111111111111111111155511111
1111111111111111111111111111111155511111
1111111111111111111111111111111155511111
1111111111111111111111111111111155511111
7778888998887788999998888887777755588899
0000000000000000000000000000008555558000
0000000000000000000000000000008555558000
0000000000000000000000000000008555558000
0000000000000000000000000000008555558000
0000000000000000000000000000008555558000
0000000000000000000000000000009555558000
0000000000000000000000000000099555588000
0000000000777777778800000000995555580000
0000000007755555555888000000955555880000
0000000077555555555558999099955555800000
0000000075555555555555559995555558800000
0000000775557888855555555555555598000000
0000000755577000999955555555555990000000
0000000755570000000999555555599900000000
0000000755570000000009999999990000000000